0 15 20
 \\\\\\\\\\\\\\\\\\\\\
 ####################\
 #   ** *   1       #\
 # # # # # # ## # # #\
 #                2 #\
 #  #*# # # # # # # #\
 #                  #\
 # #*# #*# # # # ####\
 #          *    1  #\
 # # # # # # # # # ##\
 #         *        #\
 # # #*# # # # # # ##\
 #                2 #\
 # #*# # # #*# #  # #\
 #     x   *   *    #\
 ####################\
 \\\\\\\\\\\\\\\\\\\\\