4 20 24
#                      #
########################
#     f** *  1 * 2 *  *#
# # # #*# # #*#*# # # ##
#  x*     ***  *  1   *#
# # # #s# #*# # #*#*# ##
#f         x **  *  *  #
# #b# # # # # # # #*# ##
#*  *   4  *  *      * #
# # # # #*# # # #*#*# ##
#*  5 **  *       *    #
# #*# # # # # # #*#b# ##
#    *  3    *   *  *  #
# # # # #   # # # # # ##
#   #*#   2 f   *#* *  #
# # # #     # # # # # ##
#     #         #      #
#                      #
#                      #
########################