0 16 20
 \\\\\\\\\\\\\\\\\\\\\
 ####################\
 #   ** *     *  *  #\
 # # # # # # ## # # #\
 #   *  **     1    #\
 #  # # # # # # # # #\
 #                  #\
 # #*# #*# # # # ####\
 #   b      *   2   #\
 # # # # # # # # # ##\
 #         *      s #\
 # # #*# # # # # # ##\
 #       f     2    #\
 # #*# # # #*# #  # #\
 #    1     *   *   #\
 ####################\
 \\\\\\\\\\\\\\\\\\\\\