0 16 20
 \\\\\\\\\\\\\\\\\\\\\
 ####################\
 #   ** *     *  *  #\
 # # # # # # ## # # #\
 #   *  **     1    #\
 #  # # # # # # # # #\
 #                  #\
 # #*# #*# # # # ####\
 #   b      *       #\
 # # # # # # # # # ##\
 #         *      s #\
 # # #*# # # # # # ##\
 #       f          #\
 # #*# # # #*# #  # #\
 #          *   *   #\
 ####################\
 \\\\\\\\\\\\\\\\\\\\\