1 16 24
########################
# #  * *#  #       **  #
# # #*#*  # #  # # # * #
#    * s  #            #
#*# *# # # # #*# # ##  #
#   *      *   *   *   #
# #*#b#*# # # # # # # ##
#    *  *  #*    #  b  #
# # # # # # # # # # # ##
#    #  b *   #     ** #
# # #*# # # # # # # # ##
#     f   *   *        #
# #*# # # #*# #* # # # #
#   1 x   *   *        #
#  #       *   *   *   #
########################