1 17 24
########################
#     f** *  1 * 2 *  *#
# # # #*# # #*#*# # # ##
#  x*     ***  *  1   *#
# # # #s# #*# # #*#*# ##
#f         x **  *  *  #
# #b# # # # # # # #*# ##
#*  *      *  *      * #
# # # # #*# # # #*#*# ##
#*    **  *       *    #
# #*# # # # # # #*#b# ##
#    *  3    *   *  *  #
# # # # # # # # # # # ##
#   #*#   2 f   *#* *  #
#     #         #      #
########################