0 16 20
####################
# #        1# 1    #
# # # # # ###  # # #
# #              2 #
#*##*# # # # # # # #
#                  #
# #*# #*# # # # ####
#          *       #
# # # # # # # # # ##
#         *        #
# # #*# # # # # # ##
#                2 #
# #*# # # #*# #  # #
#     x   *   *    #
####################
