0 17 24
########################
# #  * *#  # 1     **  #
# # #*#*  # #  # # # * #
#    * s  #      2     #
#*# *# # # # #*# # ##  #
#   *      *   *   *   #
# #*#b#*# # # # # # # ##
#    *  *  #*    #  b  #
# # # # # # # # # # # ##
#    #  b *   #     ** #
# # #*# # # # # # # # ##
#     f   *   *   2    #
# #*# # # #*# #* # # # #
#   1 x   *   *        #
#  #       *   *   *   #
########################